16 67
1111111111111111111111111111111111111111111111111111111111111111111
1000111111000011111111111011111111110000011111110000000000000000111
1110111111011010000010110000111111110111000000011101111111101111111
1000000000011010111010110111100000110111111111111101111111100000111
1011111111111010111010110101101110110000000001000100000011111111111
1000000000011000111000000100001110111110111100010001111011111111111
1011111111011111111111111111111110111110111111000111111000000001111
1011100000000001100000000000000000010000100000111110111011111101111
1011101111111100001111111111011111110111101111111110111011111100001
1111111111111110111101110000000000010111101111111110111011111111101
1100000011100000111101110111111111110111000000000000000011110000001
1111111011111110111101110000000000010111111111111110111111111111101
1101111000000000111101110111111011010000000000000010111111111100001
1100000011111110111000000111111011011111111111111010000000000111111
1111111111111111111111111111111111000000000000000011111111111111111
1111111111111111111111111111111111111111111111111111111111111111111
3 63 1 25


